der Krieg : war
der Atomkrieg : nuclear war
der Terrorismus : terrorism
der Klimawandel : climate change
der Klimawechsel : climate change
der Rassismus : racismus
der Treibhauseffekt : greenhouse effect
der Hungersnot : famine
der Drogenkonsum : use of drugs
der Alkoholkonsum : use of alcohol
der saure Regen : acid rain
die Obdachlosigkeit : homelessness
die Umweltverschmutzung : pollution
die Arbeitslosigkeit : unemployment
das AIDS-Risiko : the risk of AIDS
das Rauchen : smoking
das Übergewicht : obesity
das Abholzen des Regenwaldes : the clearing of rainforest
das Aussterben von bedrohten Tierarten : extinction of endangered species

erfahren : to find out, to experience
die entwickelte Länder : developed countries
die Entwicklungsländer : developing countries
schimpfen : to complain
gehören : to belong
das Zugehörigkeitsgefühl : sense of belonging
gierig : greedy
selbstbewusst : confident
unabhängig : independent
gespalten : torn

anerkennen : to recognise
anwesend : present (adjective)
begrenzt : limited
deprimierend : depressing
geldgierig : greedy, money-oriented
sogenannt : so-called

die Ausbildung : training, education
der Ausländer : foreigner
die Auswahl : choice
das Eingesperrtsein : feeling of being locked in
die Gleichheit : equality
die Gleichstellung der Geschlechte : gender equality
das Grundnahrungsmittel : basic food
der Informant : informer
der Rentner : retired person
das Staatsverbrechen : crime
der Trabi : Trabant (East German car)
der Witz : joke

ablehnen : to refuse, oppose
denunzieren : to denounce
diktieren : to dictate
fliehen : to flee, escape
sich leisten : to afford
im Vergleich mit : in comparison with
im Vergleich zu : in comparison with
in jdn Vertrauen setzen : to trust someone
verfolgen : to persecute
vorausplanen : to plan in advance
wirken : to seem, appear

jdm Sorgen bereiten : to cause someone to worry
anrufen : to call, telephone
die Stimme : voice
der Entschluss : decision
rückgängig machen : to undo, go back on
gestalten : to lay out, to arrange
zuverlässig : reliable
als etw eingestuft werden : to be classified as something
verlauten lassen : to indicate
die Ausbildung : training, education
ganz zu schweigen von : to say nothing of
deprimiert : depressed
Ungarn : Hungary
die Entschädigung : compensation
miefig : stuffy
es satt haben : to have had enough
bis zur Bahre : until the grave
regeln : to regulate
die Flucht : flight
absprechen : to arrange
erschrocken : shocked

begeistert : enthusiastic
übermitteln : to convey, transit
behaupten : to claim
etw in Aussicht haben : to have good prospects of something
einverstanden sein : to be agreed
das Begrüßungsgeld : welcome money
abholen : to pick up
sich umsehen : to look around
die Tankstelle : petrol station
meckern : to moan
der Schichtdienst : shift work
die Mauer : wall
vorstellbar : conceivable
das Herz : heart
Sächsisch : Saxon (East German dialect)
die Heiterkeit : amusement
der Erfolg : success
das Trinkgeld : tip
die Vorstellung : idea, picture
das Gefängnis : prison
die Arbeitslosigkeit : unemployment
die Reisefreiheit : freedom to travel
in einem Atemzug : in one breath

der Kunde : customer
bedienen : to serve
der Kumpel : mate
das Gefühl haben : to have the feeling
die Tochter : daughter
verkoppeln : to couple, to link uip
jdm zusetzen : to pester, press someone
zeigen : to show
strahlend : beaming
jdm zuzwinkern : to wink at someone
sich umdrehen : to turn around
kontern : to counter
die Nachricht : news
die Nachrichten : news
winzig : tiny
sich etw leisten können : to afford
der Stammkunde : regular customer
drüben : over there
anbieten : to offer
spüren : to feel

jdm unter die Arme greifen : to help someone out
meinen : to think
der Gedanke : thought
Heimweh haben : to be homesick
die Ecke : corner
das Geräusch : sound, noise
beneiden : to envy
lähmen : to paralyse
erwachsen : grown-up, adult
der Geist : spirit
sich aufrichten : to sit up straight
