der Drache : dragon
das Hufeisen : horseshoe (noun)
das Kleeblatt : clover
der Rabe : raven
schwarz : black
die Spinne : spider
die Sternschnuppe : shooting star
das Symbol : symbol
das Unglück : bad luck
vierblättrig : four-leaved (adjective)
die Winkekatze : lucky cat
der Begriff : term, concept
die Entspannung : relaxation
die Freiheit : freedom
der Frieden : peace
die Karriere : career
der Reichtum : wealth
die Ruhe : peace, quiet (noun)
die Schönheit : beauty
die Auswahl : choice
begründen : to justify
die Behandlung : treatment
bearbeiten : to edit
sich scheiden lassen : to get divorced
das Schlüsselwort : keyword
der Studienplatz : university place
die Übereinstimmung : agreement, concordance (sci)
unglücklich : unhappy
unterstreichen : to underline
die Weiterbildung : continued education
die Ansicht : opinion
sich zu D äußern : to comment on something
der Standpunkt : point of view
die Überschrift : headline
von D überzeugt sein : to be convinced of something
widersprechen : to contradict
zustimmen : to agree
der Zweifel : doubt (noun)
an D zweifeln : to doubt something
von D abhängen : to depend on something
das Aussehen : appearance
die Beziehung : relationship
die Bildung : education
dauerhaft : lasting (adjective)
die Erfüllung : fruition, realisation
innen : inside, within (adjective)
der Prozess : process (noun)
der Zustand : condition
