fröhlich : gleeful
der Frühaufsteher : early bird
der Nachtmensch : night owl
jdm schwerfallen : to be difficult for someone
die Uni : university
die Universität : university
beziehungsweise : respectively
bzw : respectively
der Biorhythmus : circadian rhythm
die Dunkelheit : darkness
die Erfindung : invention
die Folge : consequence, result
die Glühbirne : lightbulb
die Hauptaussage : main statement
immer mehr : ever more
innere : inner
das Leistungshoch : performance peak
das Leistungstief : performance trough
die Müdigkeit : fatigue, tiredness
die Uhr verstellen : to change the clock
verstellen : to adjust
die Leistungsfähigkeit : efficiency
die Empfehlung : recommendation
der Tagesablauf : daily routine
ddie Arbeitsaufgabe : work task
gestresst : stressed
der Nachmieter : next tenant
der Prüfungsstoff : test material
der Lösungsvorschlag : recommended solution
mit D über A reden : to talk with someone about something
einschlafen : to fall asleep
sich entspannen : to relax
erledigen : to take care of something
nachts : at night
schieben : to push
drücken : to push
überfordert : overwhelmed
die Wendung : phrase
einzeln : individual
das Verständnis : understanding (noun)
damals : back then
der Gliederungspunkt : bullet point
verständlich : understandable
sodass : so that