die Versuchung : temptation
die Süßigkeit : sweet (noun), candy
die Süßspeise : sweet treat
das Bonbon : bonbon, candy
der Fruchtgummi : fruit gummy
der Keks : chocolate, biscuit
der Schokoriegel : chocolate bar
aromatisch : aromatic
cremig : creamy
fruchtig : fruity
gepfeffert : peppered
gewürzt : seasoned
herb : bitter
köstlich : delicious
sahnig : creamy
säuerlich : sour
süßlich : sweet
zartbitter : bittersweet
zuckersüß : sugary

das Aroma : aroma
beeinflussen : to influence
bis zu D : up to (quantity)
enthalten : to contain
aus D entstehen : to originate from (like food)
der Ethnologe : ethnologist
das Fett : fat (noun)
das Gebiet : region
das Gefäß : jar, container
die Geschmacksvariante : flavour variety
der Geschmacksverbesserer : flavour enhancer
gesüßt : sweetened
das Glückshormon : happiness hormone
der Hauptbestandteil : principal ingredient
heilen : to heal
der Honig : honey
der Husten : cough
der Indianer : native American (noun)
der Kakao : cocoa
das Kakaopulver : cocoa powder
die Kalorie : calorie
der Karamell : caramel (noun)
das Koffein : caffeine
die Köstlichkeit : deliciousness
das Marzipan : marzipan
menschlich : human (adjective)
das Milchpulver : powdered milk
mischen : to mix
sich nahestehen : to be close to (in a friendship sense)
von D naschen : to nibble on something
die Nervennahrung : comfort food
der Nougat : nougat
die Nuss : nut
die Reihe : line (a line of products)
rund um A : to do with something
das Sahnepulver : powdered cream
der Schokoladenladen : chocolate shop
der Schokoliebhaber : chocolate lover
für A sorgen : to care for something
der Spitzenreiter : front-runner
die Tafel : bar (like chocolate)
die Variante : variant (noun)
das Vergnügen : enjoyment, delight
verraten : to betray
die Vollmilchschokolade : milk chocolate
weiterentwickeln : to develop further
wissenswert : worth knowing
das Wunder : wonder (noun)
der Zuckergehalt : sugar content
zusätzlich : additional
erstaunlich : astounding
der Feiertag : holiday, free day
verschenken : to give away
die Abkürzung : shortcut
der Bestandteil : ingredient
das Fremdwort : foreign word
der Ernährungstipp : nutrition tip
der Feinschmecker : gourmet (noun)
der Kaugummi : chewing gum
der Koch : cook (noun)
der Konditor : confectioner
der Konsument : consumer
die Mahlzeit : meal
die Nachspeise : dessert
die Torte : cake
die Zutat : ingredient
