auf A achten : to be mindful of
das Bioprodukt : organic product
der Bürger : citizen
das Etikett : etiquette
das Fertiggericht : prepared meal
die Tiefkühlware : frozen goods
der Verbraucher : user
die Vermutung : assumption, conjecture
rundum : all around, in general
der Beitrag : programme
die Aktion : campaign, action
für A werben : to advertise
durchführen : to execute, to carry out
die Tonne : tonne
unterstützen : to support
verbrauchen : to use up
das Viertel : quarter
die Brotfabrik : bread factory
ekelig : disgusting
ekelhaft : disgusting
entsorgen : to dispose of something
gestehen : to confess
lagern : to store
die Nachbarschaft : neighbourhood, proximity, vicinity
spenden : to donate
statt D : instead of something
teilen : to share
mit D umgehen : to treat someone (in a certain way)
verantwortungsvoll : responsible
wegschmeißen : to throw away
vertreten : to have (an opinion)
die Lebensmittelverschwendung : food waste