herzhaft : hearty
abnehmen : to lose weight
anfänglich : initial
zu D anregen : to encourage something
die Anwendung : application, use (of something)
die Anzahl : number, quantity
die Atemübung : breath practice
die Auswirkung : effect (on something)
bewegen : to move
die Bewegung : movement
der Beweis : proof
bilden : to form, to develop
die Dehnübung : stretching exercise
die Durchblutung : blood circulation
die Ebene : level, plane, platform
echt : real, true
das Endorphin : endorphin
erfrischen : to refresh
das Fachgebiet : field, area of expertise
fließen : to flow
in A geraten : to get into something
gering : little, slight
der Gesichtsmuskel : facial muscle
heftig : heavy, fierce
der Herzschutz : heart protection
die Kilokalorie : kcal
die Klatschübung : clapping exercise
längst : long ago
mühevoll : laborious
pantomimisch : pantomimic
praktizieren : to practise
schädlich : harmful
sogenannt : so-called
der Stresszustand : stress condition
die Träne : tear
übergehen : to pass, to skip
vermuten : to assume, to suspect
der Volksmund : folk wisdom
die Volksweisheit : folk wisdom
während : while
wertvoll : valuable
gegen D wirken : to be effective against something
die Wirkung : effect
die Wissenschaft : science
zudem : besides, moreover
beschäftigt : busy
die Medizin : medicine
verringern : to decrease, to reduce
hervorheben : to bring out, to accentuate
der Lernstoff : learning material
das Plakat : poster
vereinfachen : to simplify
das Zeichen : symbol
der Zusammenhang : context
die Erkenntnis : knowledge, realisation, perception, findings
