der Absatz : sales (singular noun)
angesehen : distinguished (adjective)
die Anlage : facility (for tennis)
der Anteil : amount
der Aufschwung : improvement, upsurge
unter D aufteilen : to split, to divide
ausscheiden : to drop out
zu D beitragen : to contribute to something
beschließen : to decide
der Besitz : ownership
die Börse : stock exchange
die Confiserie : confectionery
erbauen : to construct, to build
die Erfolgsgeschichte : success story
erhalten : to receive
erwerben : to acquire
die Fabrikanlage : factory
der Fabrikant : maker
das Fabrikationsgeheimnis : industrial secret
der Fachmann : expert, professional
fest : solid, stable
die Konditorei : confectionery, pastry shop
kräftig : powerful
der Krieg : war
die Krisenzeit : time of crisis
die Marke : brand
nach und nach : bit by bit
die Nachfrage : demand (noun)
rasch : rapid, quick
der Rückgang : decline, deterioration
der Ruf : reputation
die Schleckerei : delicacy
der Stand : level (noun)
überstehen : to withstand
überwiegend : prevailing
der Unternehmer : entrepreneur
über A verfügen : to command over something
vergrößern : to enlarge
verlagern : to extend, to renew
weitsichtig : clear-sighted, long-sighted
der Weltkrieg : world war
wesentlich : considerable
die Wirtschaftskrise : economic crisis
zusprechen : to inherit
der Zuspruch : popularity
