bieten : to offer
suchen : to look for
woanders : elsewhere
liefern : to supply, to deliver
jdm etw liefern : to deliver something to someone
günstig : favourable
günstig : cheap
gucken : to look
zelten : to camp
das Gewitter : storm
sich leisten : to afford
gründen : to found, to start, to establish
der Aufzug : elevator
die Sendung : TV programme
die Treppe : staircase
der Weltraum : space (cosmos)
eine Panne haben : to have a breakdown, to have an accident
das Bild : picture
füttern : to feed
das Gleis : train track, rail
das Gepäck : luggage

verboten : forbidden
das Untergeschoss : basement
einsam : lonely
eigen : own (my own thing)
erlauben : to allow
leer : empty
nass : wet
trocken : dry
die Einladung : invitation
genug : enough
der Himmel : sky, heaven
der Frühling : spring
bieten : to offer
freiwillig : voluntary
die Sache : thing
der Schutz : protection
die Unterkunft : accomodation
