der Ausflug : day trip
der Verkehr : traffic
ausgeben : to spend money
die Nachricht : message
die Marke : label, brand
die Mütze : cap, beanie
das Messer : knife
ekelhaft : revolting, disgusting
der Unterschied : difference
das Erlebnis : experience
der Hof : courtyard
bequem : comfortable
ruhig : quiet, peaceful
anfangen : to begin
der Fußboden : the floor (inside a room)
glauben : to believe
die Oberstufe : high school
streng : strict, harsh
die Bedienung : waiter/server
die Mahlzeit : mealtime


das Mitglied : member
der Verwandte : relative
die Unterhaltungsmöglichkeiten : possibilties of entertainment
die Tasse : cup
der Traum : dream
der Empfang : reception, welcome (of a person)
regelmäßig : regularly
der Imbiss : snack
schlieβen : to close
der Beruf : job, occupation, profession
die Lage : position (to be in the position to do something)
bevorzugen : to prefer
der Wechsel : change (noun)
der Bauernhof : farm (noun)
versuchen : to try
bitten : to ask for
auskommen mit jdm : to get on with someone
malen : to paint
stammen aus : to originate from, to date back to
langsam : slow