adoptivo : adopted
atractivo : attractive
el bebé : baby
bonito : pretty
comprometido : engaged
el cumpleaños : birthday
divorciado : divorced
estar embarazada : to be pregnant (feminine ending!)
la esposa : wife
el esposo : husband
feo : ugly
los gemelos : twins
genial : fantastic
gordo : fat
el hijo único : only child
maleducado : impolite
la mascota : pet
el matrimonio : marriage
los mellizos : unidentical twins
nervioso : nervous
el nieto : grandson
la nieta : granddaughter
el padrastro : stepfather
la madrastra : stepmother
el pariente : relative
el pasatiempo : hobby
el primo : male cousin
la prima : female cousin
el prometido : fiancé
la prometida : fiancée
quieto : still, calm
rápido : quick
rizado : curly (hair)
el sobrino : nephew
la sobrina : niece