afectar : to affect
la ambulancia : ambulance
andar : to walk
la cita médica : medical appointment
el comprimido : tablet
constipado : common cold (adjective)
la crema : cream
desde hace : for/since
dormir : to sleep
estar constipado : to have a cold
evitar : to avoid
la fiebre : fever
hacerse una herida : to get an injury
la insolación : sunstroke
el jarabe : cough syrup
el mareo : sickness
el mareo : dizziness
la pastilla : tablet
quedarse : to stay
romper : to break
el tobillo : ankle
tocar : to touch
la tos : cough

a veces : sometimes
la carrera : race (sports)
consumir : to consume
el consumo : consumption
el cuerpo : body
deportista : sporty
tres veces : three times
el ejercicio : exercise
la escalada : climbing
estar en forma : to be fit
estar saludable : to be healthy
el estilo de vida : lifestyle
físico : physical
el gimnasio : gymnasium
hacer : to do
hacer : to make
mover : to move
la musculación : bodybuilding
nadar : to swim
la natación : swimming
normalmente : normally
perder peso : to lose weight
las pesas : weights
el polideportivo : sports centre
sedentario : inactive/sedentary
solo : alone, only
tener buena salud : to be in good health
tener tiempo : to have time
una vez : once
el yoga : yoga