die Zwangsarbeit : forced labor
bedrücken : to oppress
der Vorrat : supply, stock
der Frondienst : forced labor
das Erbarmen : mercy
die Hebamme : midwife
das Rohr : reed, cane
der Nil : the Nile
das Schilf : reed, cane
jammern : to moan, lament
lohnen : to pay, reward
verscharren : to bury
wahrnehmen : to perceive
wegstoßen : to push away
seufzen : to sigh
das Wehklagen : wailing (noun)
die Erscheinung : appearance
der Bedränger : oppressor
die Gunst : favour
die Geschmeide : jewellery
der Schmuck : jewellery
die Beute : booty, loot, spoils
erhaschen : to snatch, grab
der Schwanz : tail
der Bausch : puff, bulge
das Gewand : garment
beredt : eloquent
verstocken : to harden
der Aufseher : overseer
die Pest : pestilence
der Häcksel : chaff, chopped straw
zusammenlesen : to gather together
beschaffen : to procure, obtain
beobachten : to observe
der Dreh : turn, twist, shot (film)
bestätigen : to confirm
die Razzia : police raid
die Volksverhetzung : incitement to hatred
kurzfristig : short-term, at short notice
jdn anglotzen : to stare at someone
anglotzen : to stare at someone
die Angelegenheit : matter, affair
die Verantwortung : responsibility
ganzheitlich : holistic, comprehensive
besonnen : prudent, sensible
vereinbar : compatible, consistent
die Berichterstättung : reporting, coverage
die Überheblichkeit : arrogance
überheblich : arrogant
verbreiten : to spread
