gewaltbefürwortend : advocating violence
die Züchtigung : punishment
die Verfassung : constitution
vernetzen : to network
der Knotenpunkt : node, junction, intersection
überschreiten : to exceed, surpass
unter Umständen : under certain circumstances
befürworten : to advocate, support
ausstrahlen : to broadcast
gruselig : creepy, eerie
müßig : idle, pointless
die Müßigkeit : idleness
ungeschickt : clumsy
der Frosch : frog
wimmeln : to swarm, teem
der Sumpf : swamp, marsh
der Frosch : frog
der Haufen : pile, heap
die Stechmücke : mosquito
ausrecken : to stretch out
verheeren : to devastate, ravage
der Ruß : soot
innewerden : to become aware of
als A eingestuft werden : to be classified as something
der Hagel : hail
die Heuschrecke : grasshopper
die Klaue : claw
der Sauerteig : sourdough
der Teig : dough
auslösen : to trigger, to set off, to cause
der Hals : neck
das Genick : neck
der Nacken : neck
der Hals : throat
sich verirren : to get lost
sich verlaufen : to get lost
erweisen : to confirm, to prove
die Wache : guard, watch, vigil
stürzen : to fall, to plunge
auserwählt : chosen, selected
der Widersacher : adversary, opponent
der Widerspruch : contradiction
der Grimm : anger
türmen : to pile up, to stack
der Raub : robbery, theft
das Blei : lead (metal)
erbeben : to quake, to tremble
schmelzen : to melt
verkünden : to proclaim
die Semmel : bread roll
