der Spruch : saying (noun)
jdn ansehen : to look at someone
um etw gehen : to be about (the story is about)
das Abenteuer : adventure
das Album : album
die Anfangseuphorie : initial euphoria
auf einmal : at once (suddenly)
aufgeben : to give up (e.g. never give up)
der Auftritt : performance, entrance (in music or theatre)
ausprobieren : to try out
aussehen : to appear, look like
die Band : band (music)
der Band : volume (of a book)
das Band : (conveyor) belt, ribbon, strap, tie (as in relationship)
berichten : to report
davon : thereof
eigen : own (I have my own business)
die Erde : earth
erfolgreich : successful
sich erfüllen : to be fulfilled, to come true
die Ernüchterung : disillusion
eröffnen : to open (the initial opening of something, not opening a door)
der Fernsehsender : TV channel
folgen : to follow
schummeln : to cheat (in a game or test, colloquial)
gefangen nehmen : to captivate, to arrest, to take prisoner
gelten : to be valid (like a ticket can be valid), to be allowed (in a game)
für jdn gelten : to apply to
gelten lassen : to accept (like an apology)
das Tor : goal (in football, the thing that scores a point not the goalposts)
als etw gelten : to be classified as something
jdm etwas gelten : to be directed at someone
es gilt, etw zu tun : it is essential/imperative to do something
der Gesangsunterricht : singing lesson
die Geschichte : history or story
die Grenzerfahrung : extreme experience
herausbringen : to release (like a band releasing an album)
der Klick : click
das Knie : knee
die Landschaft : landscape
wie geplant laufen : to go as planned
der Lebenstraum : lifelong dream
der Lebensunterhalt : livelihood
manche : some
mäßig : moderate, modest
die Matura : matriculation
nachdem : afterwards
nah : near
der Physiotherapeut : physiotherapist
die Praxis : practice
der Profifußballer : professional football player
die Profikarriere : professional career
der Sänger : singer
scheinen : to appear, to look like
schließlich : finally, eventually
der Schritt : step
der Star : star (like pop star)
der Stichpunkt : bullet point
die Tabelle : table
der Tanzunterricht : dance lesson
tatsächlich : indeed
trainieren : to train
sich von jdm trennen : to break up with someone
trennen : to separate
unterschiedlich : different
sich etw verwirklichen : to make something real (like a dream)
die Völkerkunde : ethnography
völlig : fully, completely
weit : far, wide
die große weite Welt : the big wide world
weiterversuchen : to try again
die Wüste : desert
zunächst : next
zusammenstellen : to put together
ausdrücken : to express
der Beispielsatz : example sentence
folgend : following (adjective)
andere : other
das Ereignis : event, incident
mündlich : verbal
die Regel : rule
die Vergangenheit : the past
verwenden : to use
der Zeitungsartikel : newspaper article
beenden : to end
unbedingt : absolutely