die Abschaffung : abolition
ähnlich : similar
anerkennen : to acknowledge
auffallen : to stand out, to attract attention
auftreten : to appear
der Ausschnitt : excerpt, detail, section
ausüben : to exert
die Auszeichnung : award, distinction
begegnen : to encounter
bereits : already
die Beschäftigung : activity, occupation
für A bewundern : to admire, to marvel
der Charakterzug : character trait
derzeitig : current
der Dirigent : conductor
die Echtheit : authenticity
der Einblick : insight
der Einfluss : influence
das Engagement : commitment, involvement
der Erfolg : success
der Fragebogen : questionnaire
geben : to give
gegenseitig : each other
das Geheimnis : secret
die Geige : violin
der Geiger : violinist
die Geisteshaltung : mindset
herausragend : prominent
interviewen : to interview
der Irrtum : mistake
die Jugend : youth
der Künstler : artist
die Leitung : guidance, leadership
das Menschenrecht : human right
musikalisch : musical
musizieren : to make music
nachhaltig : persistent
der Nachwuchs : new generation
nutzen : to make use of
die Persönlichkeit : personality
die Rassentrennung : racial segregation
die Reform : reform
die Schwäche : weakness
selten : rare
solche : such
der Solist : soloist
die Ungeduld : impatience
das Verbot : ban, prohibition
der Verfechter : advocate, champion (for something)
der Violinist : violinist
die Violine : violin
weltberühmt : world-famous
der Wettbewerb : contest
die Zusammenarbeit : collaboration, teamwork
zusammenfassend : in a nutshell, in summary
die Ausnahme : exception
der Roman : novel (big book)
die Übersicht : abstract, overview
wachsen : to grow
