der Drache : dragon
das Hufeisen : horseshoe (noun)
das Kleeblatt : clover
der Rabe : raven
schwarz : black
die Spinne : spider
die Sternschnuppe : shooting star
das Symbol : symbol
das Unglück : bad luck
vierblättrig : four-leaved (adjective)
die Winkekatze : lucky cat
der Begriff : term, concept
die Entspannung : relaxation
die Freiheit : freedom
der Frieden : peace
die Karriere : career
der Reichtum : wealth
die Ruhe : peace, quiet (noun)
die Schönheit : beauty
die Auswahl : choice
begründen : to justify
die Behandlung : treatment
bearbeiten : to edit
sich scheiden lassen : to get divorced
das Schlüsselwort : keyword
der Studienplatz : university place
die Übereinstimmung : agreement, concordance (sci)
unglücklich : unhappy
unterstreichen : to underline
die Weiterbildung : continued education
die Ansicht : opinion
sich zu D äußern : to comment on something
der Standpunkt : point of view
die Überschrift : headline
von D überzeugt sein : to be convinced of something
widersprechen : to contradict
zustimmen : to agree
der Zweifel : doubt (noun)
an D zweifeln : to doubt something
von D abhängen : to depend on something
das Aussehen : appearance
die Beziehung : relationship
die Bildung : education
dauerhaft : lasting (adjective)
die Erfüllung : fruition, realisation
innen : inside, within (adjective)
der Prozess : process (noun)
der Zustand : condition

abergläubisch : superstitious
die Aktentasche : briefcase
anhaben : to have something on (to be wearing)
anstellen : to switch on
belehren : to instruct
besondere : special
der Blogeintrag : blogpost
bloß : just, only (if only I hadn't...)
durchsehen : to examine
einschenken : to pour
die Erleichterung : relief
erwachen : to awake (formal)
feststellen : to notice
greifen : to grasp, reach
halten : to hold
heutig : present-day, current
die Kaffeekanne : coffee pot
der Knall : bang
die Müllabfuhr : rubbish collection
offensichtlich : obviously
offenbar : apparently
die Runde : lap (in racing), round (noun)
das Schicksal : fate
der Schreibtisch : desk
die Sprung : jump (noun)
spucken : to spit
stoßen : to bump (I bumped the glass off the table)
der Strumpf : sock
überhaupt : at all
unruhig : anxious, restless
die Unterlagen : documents, papers
verschlafen : to oversleep
die Zahnpasta : toothpaste
zusammenkommen : to come together
der Erzähler : narrator
das Missgeschick : misfortune
der Ausdruck : expression
beachten : to obey
durcheinander : jumbled, disorganised
die Erklärung : explanation
schaden : to damage, harm
von D überzeugen : to convince
das Pech : bad luck
der Spiegel : mirror
zerbrechen : to break
die Eckdaten : basic information (plural)
die Geburt : birth
der Kreißsaal : delivery room
üblich : usual
verlaufen : to proceed
weitgehend : by and large
wiegen : to weigh
aussprechen : to pronounce
die Nachricht : news
auf A reagieren : to react
riesig : enormous
bedanken : to thank
zu D beglückwünschen : to congratulate with something
sich nach D erkundigen : to inquire about something
sich bei D erkundigen : to inquire about something
der Punkt : point
