der Nesthocker : someone who never moves out of his childhood home
ungewöhnlich : unconventional
der Ablösungsprozess : emancipation process
angeben : to state, to indicate
anhänglich : clingy
der Anspruch : claim, entitlement
die Ausbildungszeit : education time
ausgeglichen : balanced, even
beherbergen : to accomodate, to house
die Bequemlichkeit : comfort
das Berufsleben : professional life
beweisen : to confirm, to prove
das Bundesamt : federal office
dagegen : in contrast with that
daher : because of this, therefore
darunter : among them
der Durchschnitt : average (noun)
eher : earlier
eindeutig : clear, unambiguous
eintreten : to enter
entwickeln : to develop
die Erziehungsmethode : method of education
gemeinsam : together
geputzt : cleaned
geschehen : to happen
halten : to hold
ein Versprechen halten : to keep a promise
die Heirat : wedding
immerhin : after all, anyway
individuell : individual
mit D klarkommen : to get along with someone
lediglich : only, merely
melden : to report, to notify
neben D : alongside, in addition to
nennen : to name, to cite
räumlich : spatial, three-dimensional
rein : pure, simple
selbstverständlich : as a matter of course
steigen : to climb, to increase
die Trennung : separation
unabhängig : independent
verantwortlich : responsible
vielschichtig : multilayered
wissenschaftlich : scientific
der Textabschnitt : text excerpt
verlassen : to leave
unterscheiden : to distinguish
anstrengend : stressful
sich in A einarbeiten : to familiarise oneself with something
erst mal : first of all
der Gruß : greeting
knapp : scarce
der Krankenpfleger : nurse (male)
der Stress : stress
überfliegen : to skim read
vorbei sein : to be over/finished
zwar : but
der Ratschlag : piece of advice
die Anrede : form of address
dabei : at the same time, thereby
die Grußformel : salutation
der Nachteil : drawback
die Sicht : sight, view
der Vorteil : advantage
von D abraten : to advise against something
die Anstellung : employment, position
der Anwalt : lawyer
der Arzt : doctor
befürchten : to fear
zu D ermutigen : to encourage something
der Mitbewohner : flatmate
zu D raten : to advise something
das Rollenspiel : roleplay
übernehmen : to take over
die Unterstützung : support
der Verkäufer : salesman
die Wahl : choice
die Wohngemeinschaft : apartment-sharing community
