die Obdachlosigkeit : homelessness
die Arbeitslosigkeit : unemployment
die Armut : poverty
die Chancenlosigkeit : lack of opportunity
sich links einordnen : to change lanes to the left
sich rechts einordnen : to change lanes to the right
sich einordnen : to fit in to a community
die Einsamkeit : loneliness
die Erfolglosigkeit : lack of success
jdm Gesellschaft leisten : to keep someone company
das Hilfsangebot : offer of help
die Hoffnung : hope
die Krankheit : sickness
die Möglichkeit : possibility
die Notunterkunft : emergency shelter
die Randgruppe : marginal group
die Scheidung : divorce (noun)
verschuldet sein : to be in debt
sich verschulden : to get into debt
schuldenfrei sein : to be out of debt
die Schuld : debt
das Sozialamt : welfare agency
die Ursache : cause
das Wohnheim : housing
je : each
der Obdachlose : homeless person
jdm etw ansprechen : to address something to someone
möglichst schnell : as quickly as possible
das Schema : scheme, diagram
das Stichwort : keyword
thematisch : thematically
die Themengruppe : theme group
das Ziel : goal (that you work towards)
die Gemeinsamkeit : common ground
obdachlos : homeless
der Staat : country, state
