der Anhang : attachment, appendix
architektonisch : architecturally
die Art : kind, type
die Attraktion : attraction
bauen : to build
das Bauwerk : structure
sich befinden : to be located
der Bereich : field, area, sector
der Besucher : visitor
die Burg : fortress
decken : to set (the table)
deutschsprachig : German-speaking
durch A dringen : to get through something
das Eingangstor : entrance gate
erschöpft : exhausted
die Fantasie : fantasy
der Farbeffekt : colour effect
der Fortschritt : progress (noun)
das Gerücht : rumour
ideal : ideal
das Inland : inner country
innerhalb G : within
insgesamt : altogether, in total
das Jahrhundert : century
der Kastellan : constable
der Klangeffekt : sound effect
klicken : to click
der König : king
das Königshaus : royal house
der Königspalast : royal palace
die Kulisse : setting, backdrop
die Kunst : art
künstlich : artificial
der Laut : sound
lebhaft : lively
legen : to lay
der Lichteffekt : lightning effect
das Märchenschloss : fairytale castle
die Mauer : wall
menschenscheu : afraid of people
meterdick : metre-thick
das Mitglied : member
der Mond : moon
die Neugierde : curiosity
das Personal : staff
die Romantik : romance, romanticism
das Schlafzimmer : bedroom
schleusen : to funnel, smuggle
das Schloss : castle
die Sehnsucht : longing, yearning
speisen : to dine
das Speisezimmer : dining room
der Sternenhimmel : starry sky
der Stil : style
die Stille : stillness
das Stockwerk : floor, storey
technisch : technically
die Traumwelt : dream world
umringen : to surround
mit D verknüpfen : to attach, connect
versenkbar : retractable
verstecken : to hide, conceal
verträumt : dreamy
das Vorbild : example, role model
die Vorlage : model, guideline
zuprosten : to toast (in a drinks sense)
sich zurückziehen : to withdraw oneself

der Bandit : bandit
der Bauer : farmer
beistehen : to stand by
darstellen : to depict, represent
der Doktorand : doctoral candidate
der Fall : case (in any case)
fortlaufen : to run away
der Glaube : belief
hinfallen : to fall down
missfallen : to disapprove (impersonal verb)
über A nachdenken : to contemplate, to think
der Polizist : police officer
der Praktikant : intern
der Soldat : soldier
weglaufen : to run away