die Badewanne : bathtub
von D erwarten : to expect from someone
gemütlich : comfortable
der Abenteuerroman : adventure novel
angenehm : pleasant
mit D ausstatten : to furnish with something
der Autor : author
der Besitzer : owner
betreten : to enter
bewegend : evocative, moving
die Branche : sector
bunt : colourful
dafür : for that
darum : thus (I don't get along with my parents anymore; thus, I want to move out)
der Dompteur : animal tamer/trainer
ehemalig : former
einst : one day
einst : once upon a time
erleben : to experience
der Euro : euro
die Fluggesellschaft : airline company
das Forschungslabor : research laboratory
die Gemütlichkeit : comfort
glanzvoll : glamorous
hinabtauchen : to dive under
in A investieren : to invest into something
jene : those
der Löwe : lion
die Luxusherberge : luxury hotel
die Manege : arena
die Meile : mile
der Meter : metre
der Präsident : president
das Publikum : audience
die Sägespäne : sawdust
die Sauna : sauna
der Schlafplatz : place to sleep
sogar : even (as in even though)
der Spaß : fun (noun)
tauchen : to dive
die Tournee : tour (noun)
auf Tournee gehen : to go on tour
umbauen : to reconstruct
etw zu D umfunktionieren : to convert something into something
die Umgebung : surroundings
unterwegs : on the way
der Vorschlag : suggestion
zahlend : paying (adjective)
der Zirkus : circus
der Zirkuswagen : circus wagon
durchstreichen : to cross out
vorlesen : to read aloud
faszinierend : fascinating