finster : dark
schweben : to float, hover
geschehen : to happen, to be done (as in, thy will be done)
aufgehen : to rise, to go up
jegliche : every, any
sich besamen : to pollinate
das Zeichen : sign, symbol
erregen : to excite, arouse
weben : to weave
gefiedert : feathered
das Vieh : cattle, livestock
kriechen : to crawl
segnen : to bless
vollenden : to accomplish, to complete
das Nebel : fog
feuchten : to moisten
der Erdenkloß : clod of earth
bewahren : to preserve, to keep
nackt : naked
sich schämen : to be ashamed
die Scham : shame
anrühren : to touch
anschauen : to look at
von D gewahr werden : to become aware of something
sich fürchten : to be afraid
betrügen : to deceive
verflucht : cursed
gebären : to give birth
das Verlangen : desire (noun)
der Acker : field
der Dorn : thorn
der Distel : thistle
wie unsereiner : like one of us
der Schweiß : sweat
der Schwert : sword
der Opfer : sacrifice
gnädig : gracious
ergrimmten : to enrage
die Gebärde : gesture
fromm : pious
der Hüter : guardian