hinfort : henceforth
unstet : restless
die Sünde : sin
vergeben : forgive
rächen : avenge
erschlagen : slay
die Beule : bump, swelling, bruise
die Wunde : wound
hinweg nehmen : to take away
trösten : to comfort
der Gewaltige : the mighty (one)
vertilgen : to destroy
die Bosheit : wickedness
bereuen : to regret, repent
die Gnade : grace
der Tadel : blame
verderben : to ruin
die Strafe : punishment
der Kasten : chest, box
inwendig : inward
auswendig : outward
die Elle : ell
die Flut : flood
das Odem : breath
gerecht : just, righteous, fair
die Gerechtigkeit : righteousness
desgleichen : likewise
das Wesen : being, essence
das Brunnen : well (of water)
die Quelle : spring, source
aufbrechen : to break open, to burst, to break out
der Fittich : wing
überhand nehmen : to get out of hand
überhandnehmen : to get out of hand
bedeckt : covered
übrig : remaining
das Gebirge : mountain
der Berg : mountain
die Spitze : peak, summit, top
die Taube : dove
die Schwalbe : swallow
abermals : again
das Dichten : poetry, verse, composition, writing
die Saat : seed
die Ernte : harvest
der Frost : frost
die Hitze : heat
