vergießen : to shed (tears, blood)
der Bund : covenant, alliance
der Bogen : bow
die Wolke : cloud
aufrichten : to erect, to set up, to establish
der Weinberg : vineyard
aufgedeckt : uncovered, revealed, exposed
die Blöße : nakedness, exposure
der Heide : heathen, pagan, gentile
wohlauf : arise, get up (command)
der Ziegel : brick, tile, block
streichen : to stroke, to paint, to smear
brennen : to burn
das Erdharz : bitumen, asphalt, tar
der Kalk : chalk
zerstreuen : to scatter, to disperse
erscheinen : to appear
predigen : to preach, to proclaim
die Teuerung : dearth, scarcity, famine
erwürgen : to strangle, to choke
der Fürst : prince, ruler (medieval)
der Pharao : pharaoh
der Esel : donkey
ertragen : to bear, to endure
der Hirt : shepherd (biblical)
der Hirte : shepherd (biblical)
der Zank : quarrel, dispute
der Streit : quarrel, dispute
besehen : to look at, to inspect
sündigen : to sin
der Staub : dust
sich aufmachen : to set out, to start off
sich an A begeben : to go somewhere (formal)
von jdm abgefallen sein : to have deserted someone
von D abgefallen sein : to have deserted someone
der Riese : giant
stoßen : to push, to shove
die Erdharzgrube : bitumen pit
entrinnen : to escape
der Knecht : servant, slave
jagen : to hunt
der Faden : thread
der Schuhriemen : shoelace
verzehren : to consume, to eat
der Hain : grove, copse
das Gesinde : servants, staff (singular noun, archaic)
der Erbe : heir, inheritance
der Leib : body
die Ziege : goat
der Widder : ram (noun, animal)
die Turteltaube : turtledove
davon scheuchen : to scare away
jdn überfallen : to attack someone, to fall upon someone
dienen : to serve
zwingen : to force, to compel
plagen : to plague, to torment
richten : to judge
der Ofen : oven
die Magd : maid, servant
