der Richter : judge (noun)
demütigen : to humiliate
gewiss : certain, sure
beschneiden : to circumcise
die Vorhaut : foreskin
ausrotten : to exterminate, eradicate
erhören : to grant, answer (a prayer)
auffahren : to drive up, pull up
ebendesselben : the very same
daheim : at home
zu Hause : at home
allmächtig : almighty
bücken : to bend down
der Bissen : bite (of food)
erscheinen : to appear
die Wollust : lust, pleasure
leugnen : to deny
verbergen : to hide
umbringen : to kill
sich unterwinden : to dare
zürnen : to be angry
der Zorn : anger
der Zorn Gottes : the wrath of God
jdn nötigen : to force someone
übel : evil
der Schatten : shadow
die Morgenröte : dawn
vorhanden : present, available
umkommen : to perish
erretten : to save
die Barmherzigkeit : mercy
der Schwefel : sulphur
die Salzsäule : pillar of salt
der Rauch : smoke
die Höhle : cave
berühren : to touch
erwürgen : to strangle
einfältig : simple, naive, simple-minded
unschuldig : innocent
zugeben : to admit, to add
wahrhaftig : truthful, honest
zurichten : to prepare
der Spötter : satirist, mocker
erben : to inherit
der Knabe : boy, lad
der Schlauch : hose, tube
der Strauch : bush, shrub
graben : to dig
die Kebse : concubine
beweinen : to mourn
die Leiche : corpse
das Erbbegräbnis : vault
begraben : to bury
sich vor jdm bücken : to bow before someone