allenthalben : on all sides, everywhere (literary)
vorstehen : to project, to stick out, to protrude
die Hüfte : hip
die Dirne : prostitute
der Krug : jug
neigen : to bend, to tip, to incline
die Achsel : armpit
das Stroh : straw
das Kleinod : jewel, gem
loben : to praise
samt und sonders : the whole lot (of them)
rötlich : reddish
rau : rough, tough, rugged
das Fell : fur, fleece
die Ferse : heel
streifen : to brush, to scrape, to touch
sanft : gentle, soft
das Weidwerk : art of hunting
antasten : to touch, to feel
säen : to sow
gehorsam : obedient
die Weise : manner, way
der Eid : oath
das Herzeleid : heartache
das Wildbret : game (meat)
glatt : smooth, sleek, slippery
überlisten : to outwit, to outsmart
das Joch : yoke
hinschicken : to send away
beraubt : robbed
verdrießen : to annoy, to vex
die Pforte : gate, portal
obendarauf : on top of that
die Stätte : place, site
das Gelübde : vow
die Herde : herd, flock
der Loch : hole
eintreiben : to drive in, to collect
hüten : to guard, to tend
wohlan : well then, ....
unwert : unworthy
das Elend : misery, wretchedness
der Schoß : lap
rüstig : vigorous, robust
die Weize : wheat
sprenklig : speckled
weiden : to graze
der Pappelbaum : poplar tree
die Hasel : hazel
