die Kastanie : chestnut
schalen : to peel, to shell
der Stab : staff, stick
die Rinne : gutter, channel
entwenden : to steal, to pilfer
salben : to anoint
täuschen : to deceive, to delude
ansagen : to announce, to declare
jdn ereilen : to overtake someone, to catch up with someone
entführen : to abduct, to kidnap
töricht : foolish, silly
die Götze : idol
erhitzt : heated, inflamed
das Zeugnis : testimony, evidence
der Zeuge : witness
das Heer : army
die Armee : army
säugend : suckling
der Farre : bullock
das Füllen : foal
das Fohlen : foal
jdn versöhnen : to reconcile someone
verrenken : to dislocate
überwältigen : to overpower, to overwhelm
das Gelenk : joint
die Furt : ford
sich neigen : to incline, to lean
bescheren : to bestow, to grant
fortziehen : to migrate, to move on
vonnöten : necessary
der Groschen : penny
der Pfennig : penny
die Münze : coin
geschändet : desecrated
heischen : to beg, to demand
die Schande : disgrace
die Schmach : disgrace
friedsam : peaceful
kühn : bold, daring
plündern : to plunder, to loot
die Trübsal : affliction, distress
die Amme : nurse
das Mal : mark, spot
gießen : to pour, to cast
das Trankopfer : libation, drink offering
begießen : to water, to irrigate
das Grabmal : tomb
die Gruft : tomb
der Enkel : grandson
der Urenkel : great-grandson
der Großenkel : great-grandson
der Erbland : hereditary land
die Erbschaft : inheritance