ausdrücken : to express
der Beispielsatz : example sentence
folgend : following (adjective)
andere : other
das Ereignis : event, incident
mündlich : verbal
die Regel : rule
die Vergangenheit : the past
verwenden : to use
der Zeitungsartikel : newspaper article
beenden : to end
unbedingt : absolutely
erkennen : to recognize
heutzutage : nowadays
pflegen : to cultivate
schwierig : difficult
stressig : stressful
ehrgeizig : ambitious
die Eigenschaft : characteristic
gebildet : educated (adjective)
großzügig : generous
gut aussehend : good-looking
hilfsbereit : helpful
der Humor : humour
loyal : loyal
sportlich : athletic, sporty
unternehmungslustig : adventurous
verantwortungsbewusst : responsible
vergleichen : to compare
verschwiegen : discreet
witzig : funny
zuverlässig : reliable
der Abschnitt : section, paragraph
auf etw ankommen : to depend on (accusative)
beantworten : to answer
passend : suitable, matching
bestimmt : certain (like the phrase "certain things")
das Netzwerk : network
nummerieren : to number
die Phase : phase
der Radiobeitrag : radio programme
die Reihenfolge : order, sequence
das Redemittel : phrase
das Ergebnis : result
zu etw führen : to lead to (dative)
über etw informieren : to inform about something
die Rolle : role
spielen : to play
stehen : to stand
die Stelle : place, spot
die Redewendung : idiom
der Reim : rhyme
das Sprichwort : proverb