bezeichnen : to label, characterise
der Held : hero
verbessern : to improve
unter D verstehen : to mean by something (what do you mean by this?)
verstehen : to understand
der Grund : reason (for something)
die Umfrage : survey, poll
das Armenviertel : slum
sich gegen A einsetzen : to take a stand against something
entdecken : to discover
kämpfen : to fight
sich um A kümmern : to look after something
kümmern : to shrivel
kümmern : to concern (it concerns me)
der Leprakranke : leper
mithilfe G : with the help of
umkreisen : to circle
der Alltag : everyday life
der Einsatz : dedication
ertrinken : to drown
fassen : to grab, to seize, to draw munition
gelingen : to succeed (impersonal verb)
herausziehen : to pull out
die Kraft : strength, power
lebensrettend : lifesaving
loslassen : to let go
nahegehen D : to affect
jdn vor jdm retten : to rescue someone from someone
die Rettung : rescue (noun)
schaffen : to manage, to accomplish
die Strömung : current (of water, or idiomatic)
überleben : to survive
überlegen : to think through
das Ufer : shore
untergehen : to go under
zusammenfassen : to summarise
heldenhaft : heroic
abwechslungsreich : varied, diversified
die Bahnhofsmission : charitable organisation for helping needy passengers, traveller aid
begleiten : to accompany (also musical)
behindert : handicapped
belegt : hoarse (voice), occupied (house)
die Biografie : biography
dankbar : thankful
ehrenamtlich : voluntary
der Mitmensch : fellow human
der Reisende : traveller
die Reiseverbindung : travel connection
tätig : active
sich engagieren : to become involved
erforschen : to investigate, to research
mit D experimentieren : to experiment with
formulieren : to formulate
die Herkunft : origin
die Leistung : performance
aushängen : to put up (a poster)


