arbeitslos : unemployed
das Getränk : drink (noun)
das Erdgeschoss : ground floor
das Gewitter : storm
bunt : multicoloured
mieten : to rent
hässlich : ugly
anfangen : to begin
zusammen : together
der Kühlschrank : fridge
bevorzugen : to prefer
der Baum : tree
der Herd : oven
der Teller : the plate
der Wettbewerb : competition
die Konkurrenz : competition
klug : clever
der Schnurrbart : moustache
das Gesicht : face

der Rat : advice (noun)
mager : thin
der Abfall : rubbish
der Müll : rubbish
das Gericht : dish
verlieren : to lose
dort : there
dorthin : to there
der Ausgang : the exit
überall : everywhere
der Regenschirm : umbrella
der Himmel : heaven
der Fluss : river
die Rückfahrkarte : return ticket
der Unterricht : the lesson
die Unterhaltung : entertainment
die Ausbildung : education, training
das Schiff : ship
traurig : sad
lächeln : to smile
lachen : to laugh
wahr : true

zufrieden : content (adjective)
die Klamotten : clothes (slang)
einschlafen : to fall asleep
der Ausflug : day trip
das Reiseziel : destinationj
das Messer : knife
höflich : polite
die Ernährung : diet
gleich : same
ähnlich : similar
einzig : only (the only one)
zeichnen : to draw
malen : to paint
gemütlich : comfortable/cosy
der Radweg : bike path
die Note : school grade
brauchen : to need
kriegen : to receive
bekommen : to receive
der Lohn : salary
klingeln : to ring
klingen : to sound
