sonst : otherwise
die Bank : bank, bench, seat, pew
das Lager : camp, bed, store, warehouse
die Vernichtung : destruction, annihilation
das KZ : concentration camp
die Gaskammer : gas chamber
die Verbrennung : burning, cremation
die Asche : ash
erträglich : bearable, tolerable
die Hölle : hell
der Stacheldraht : barbed wire
unterbringen : to accommodate, to house
beherbergen : to accommodate, to house
antreten : to line up, to form up
zulassen : to allow, to permit
die Lumpen : rags, tatters (plural noun)
die Zwangsarbeit : forced labour
der Überlebende : survivor
die Überlebende : survivor
die Lok : locomotive
die Lokomotive : locomotive
die Eisenbahn : railway
die Gartenlaube : garden shed
die Schublade : drawer
pferchen : to cram, to pack
der Heranwachsender : adolescent
die Heranwachsende : adolescent
der Jugendliche : adolescent
die Jugendliche : adolescent
unauffällig : inconspicuous, unobtrusive
fassungslos : speechless, stunned
die Ahnungslosigkeit : cluelessness
die Unwissenheit : ignorance
angesichts : in the face of, in view of
unterschätzen : to underestimate
